[level]
tileset = ground.png
map =   XXX.XXXXXXXXXXX....XXXXX......................
        X.......X.X.X.X....XXXXX......................
        X.>....X.X...XX....XXXXX........XXXXX.........
        X...@.......X.X....XXXXX......................
        X......s...X.XX....XXXXX......................
        X.........................XXXXX...............
        XX.X.X.X...X.XX....XXXXX......................
        X...........X.X....XXXXX......................
        XX.X.X.X......X....XXXXX......................
        ...........s..X........X...........XXXXX......
        XX.XX.XXX.....X....XXXXX......................
        X..XX.XXX...X.X...............................
        XX.XX.XXX....XX....XXXXX......................
        X.....XXX...X.X........X......................
        XXXXXXX....XXXX....XXXXX......................
	XX.XX.XXX.....X....XXXXX.........XXXXX.......
	X.............................................
	X......................X......................

[X]
name = wall
wall = true
block = true

[.]
name = floor
tile = 2, 3

[@]
name = player
tile = 2,3
player = true
sprite = player.png

[s]
name = skeleton
tile = 0, 3
sprite = skeleton.png
block = true

[>]
name = stairs
block = true
tile = 3, 3

